ㄱㅏㅇㅡㄹ	G A EU L
ㄱㅏㅅㅓ	G A S EO
ㄱㅏㄱㅔ	G A G E
ㄱㅏㅁㅏㄴㅎㅣ	G A M A N I
ㄱㅏㄱㅜㅇㅢ	G A G U euI
ㄱㅏㅈㅗㄱㅇㅣ	G A J O G I
ㄱㅏ	G A
ㄱㅏㅅㅡㅁㅇㅣ	G A S EU M I
ㄱㅏㅈㅏ	G A J A
ㄱㅏㄴㅈㅏㅇ	G A N J A NG
ㄱㅏㄴㅅㅣㄱ	G A N S I k
ㄱㅏㄹㄲㅏ	G A L GG A
ㄱㅏㄹㄷㅐㅇㅔ	G A L D E E
ㄱㅏㄹㄷㅡㅇ	G A L D EU NG
ㄱㅏㄹㅂㅣ	G A L B I
ㄱㅏㅁㄱㅣ	G A M G I
ㄱㅏㅁㅅㅏㅇㅢ	G A M S A euI
ㄱㅏㅁㅅㅏㅎㅏㅂㄴㅣㄷㅏ	G A M S A A M N I D A
ㄱㅏㅆㄷㅏ	G A t DD A
ㄱㅏㅆㅇㅓㅇㅛ	G A SS EO iO
ㄱㅏㅆㅈㅣ	G A t JJ I
ㄱㅏㅌㅇㅣ	G A Th I
ㄱㅏㅍㅇㅏㅆㄷㅏ	G A Ph A t DD A
ㄱㅓㅅㅇㅣ	G EO S I
ㄱㅓㄷㅎㅣㄴ	G EO Th I N
ㄱㅏㅈㄷㅏ	G A t DD A
ㄱㅓㅇㅑ	G EO iA
ㄱㅏㅌㅅㅡㅂㄴㅣㄷㅏ	G A t SS EU M N I D A
ㄱㅏㅌㅇㅡㄴ	G A Th EU N
ㄱㅓㄹㄹㅕㅇㅛ	G EO L L iEO iO
ㄱㅓ	G EO
ㄱㅕㄹㅈㅓㅇㅇㅡㄴ	G iEO L J EO NG EU N
ㄱㅖㅅㅗㄱㅎㅏㄹ	G iE S O Kh A L
ㄱㅘㄴㅅㅣㅁㅇㅣ	G oA N S I M I
ㄱㅗㅇㄱㅝㄴㄹㅕㄱㅇㅢ	G O NG G uEO N N iEO G euI
ㄱㅓㅅ	G EO t
ㄱㅗㅎㅑㅇㅇㅔㅅㅓㄴㅡㄴ	G O iA NG E S EO N EU N
ㄱㅓㄹ	G EO L
ㄱㅓㅅㅇㅡㄹ	G EO S EU L
ㄱㅗㅇㅂㅜㅎㅏㄱㅔ	G O NG B U A G E
ㄱㅔ	G E
ㄱㅙㄴㅊㅏㄶㄷㅏ	G OE N CHh A N Th A
ㄱㅚㅁㅜㄹ	G OE M U L
ㄱㅡㄴㄹㅗㅈㅏ	G EU N N O J A
ㄱㅜㄱㅇㅣ	G U G I
ㄱㅕㄲㄷㅏ	G iEO k DD A
ㄱㅜㄱㅁㅣㄴ	G U NG M I N
ㄱㅕㄱㄹㅕ	G iEO NG N iEO
ㄱㅖㅅㅔㅇㅛ	G iE S E iO
ㄱㅜㅎㅏㄷㅏ	G U A D A
ㄱㅗㅈㅓ	Kh O J EO
ㄱㅟ	G UI
ㄱㅡ	G EU
ㄲㅗㅊ	G O N
ㄱㅡㅁㅏㄴ	G EU M A N
ㄱㅗㅇㅉㅏ	G O NG JJ A
ㄱㅡㄹㅣㅁ	G EU R I M
ㄱㅗㅇㅂㅜㅎㅐㅆㅅㅡㅂㄴㅣㄷㅏ	G O NG B U E S SS EU M N I D A
ㄱㅗㅇㅎㅏㅇㄱㅘ	G O NG H A NG G oA
ㄱㅡㄱㅓㅅㄷㅗ	G EU G EO t DD O
ㄱㅗㅇㅎㅏㅇㅇㅣ	G O NG H A NG I
ㄱㅣㄴㅡㅇㅇㅣ	G I N EU NG I
ㄱㅣㄷㅏㄹㅕ	G I D A R iEO
ㄴㅐㅇㅛㅇㅇㅡㄹ	N E iO NG EU L
ㄱㅣㅁㅊㅣ	G I M CHh I
ㄱㅜㄷㅜ	G U D U
ㄱㅣㄹㅇㅣ	G I R I
ㄱㅘㅈㅓㅇ	G oA J EO NG
ㄱㅛㅇㅠㄱㅇㅕㄹ	G iO iU G iEO R
ㄱㅣㄷㅏㄹㅣㄷㅏ	G I D A R I D A
ㄱㅜㄱㄴㅐㅅㅓㄴ	G U NG N E S EO N
ㄲㅗㄱ	GG O k
ㄲㅡㄶㅈㅣㅁㅏㄴ	GG EU N CHh I M A N
ㄷㅏㄹㅡㄴ	D A R EU N
ㄴㅏㄱㅏ	N A G A
ㄱㅝㄴㄹㅕㄱㄱㅘ	G uEO N N iEO k GG oA
ㄴㅏ	N A
ㄱㅜㄱㅈㅔㅅㅓㄴ	G U k JJ E S EO N
ㄱㅜㅇㄹㅣ	G U NG N I
ㄲㅗㅊㅇㅡㄹ	GG O CHh EU L
ㄱㅝㄴㅎㅏㄷㅏ	G uEO N A D A
ㄴㅏㄴㅡㄴ	N A N EU N
ㄴㅏㅈㅜㅇㅇㅔ	N A J U NG E
ㄷㅚㄴㅡㄴㄷㅔ	D OE N EU N D E
ㄴㅓㅁㅜ	N EO M U
ㄱㅡㄹㅡㅅ	G EU R EU S
ㄴㅓ	N EO
ㄱㅡㄱㅓ	G EU G EO
ㄱㅡㄹㅓㄴㄷㅔ	G EU R EO N D E
ㄴㅏㅅㅔㅇㅛ	N A S E iO
ㄱㅡㄹㅓㅎㄱㅔ	G EU R EO Kh E
ㄴㅗㄹㅕㄱ	N O R iEO k
ㄴㅗㄹㅕㄱㅇㅡㄹ	N O R iEO G EU L
ㄸㅐㅁㅜㄴㅇㅣㄷㅏ	D E M U N I D A
ㄴㅣ	N I
ㄱㅡㅂㅎㅏㄴ	G EU Ph A N
ㄴㅡㅈㅇㅡㅅㅣㅁㅕㄴ	N EU J EU S I M iEO N
ㄱㅡㄹㅆㅣ	G EU L SS I
ㄱㅡㅁㅇㅛㅇㅣㄹㅇㅣ	G EU M iO I R I
ㄱㅣㅂㅗㄴㅇㅣㄹㅏㄱㅗ	G I B O N I R A G O
ㄴㅓㅎㅇㅓㅇㅛ	N EO EO iO
ㄷㅏ	D A
ㄷㅏㄴㅣㄴㅣ	D A N I N I
ㄷㅓ	D EO
ㄷㅓㅇㅝㅇㅛ	D EO uEO iO
ㄷㅡㅅㅔㅇㅛ	D EU S E iO
ㄷㅏㅇㅈㅏㅇ	D A NG J A NG
ㄱㅣㅁㅏㄱㅎㅣㄷㅏ	G I M A Kh I D A
ㄱㅡㅂㅎㅏㄷㅏ	G EU Ph A D A
ㄲㅗㄹㅣ	GG O R I
ㄴㅡㅈㅇㅓㅆㅈㅣㅁㅏㄴ	N EU J EO t JJ I M A N
ㅁㅏㄶㅇㅣ	M A N I
ㄸㅗ	DD O
ㄷㅏㄷㅎㅣㄷㅏ	D A Th I D A
ㄱㅣㅃㅡㅂㄴㅣㄷㅏ	G I BB EU M N I D A
ㄷㅐㄷㅏㄴㅎㅏㄴㅔㅇㅛ	D E D A N A N E iO
ㄲㅐㄲㅡㅅㅇㅣ	GG E GG EU S I
ㄱㅣㅂㅜㄱㅡㅁㅇㅡㄹㅗ	G I B U G EU M EU R O
ㄷㅡㄷㄱㅗ	D EU t GG O
ㄲㅡㅌㄴㅏㅆㅇㅡㄹㄱㅓㄹ	GG EU N N A SS EU L G EO L
ㄷㅟㅅㅇㅣㄹㅇㅡㄴ	D UI S I R EU N
ㄴㅏㅁㅜㅅㅇㅣㅍ	N A M U S I M
ㄸㅏㄱ	D A Kh
ㄴㅐㄱㅏ	N E G A
ㄷㅚㄹㄲㅏㅇㅛ	D OE L GG A iO
ㄲㅡㅂㅅㅣㄷㅏ	G EU p SS I D A
ㄷㅡㄹㅇㅓㅆㄴㅡㄴㄷㅔ	D EU R EO N N EU N D E
ㄴㅏㄱㅏㅆㄴㅡㄴㄷㅔ	N A G A N N EU N D E
ㄸㅏㄸㅡㅅㅎㅏㅈㅣㅇㅛ	D A DD EU Th A J I iO
ㅁㅏㄹㅆㅡㅁㅇㅡㄹ	M A L SS EU M EU L
ㅁㅓㄴㅈㅓ	M EO N J EO
ㅁㅏㄶㅇㅡㄹ	M A N EU L
ㅁㅜㄴ	M U N
ㄲㅡㅀㄴㅡㄴㄷㅔ	G EU N N EU N D E
ㅂㅏㄹㅏㅂㄴㅣㄷㅏ	B A R A M N I D A
ㄷㅡㅅㅣㄹ	D EU S I N
ㅁㅏㄱㅎㅣㄴㅏ	M A Kh I N A
ㄴㅏㅈㅇㅏㅇㅛ	N A J A iO
ㅁㅓㄱㅇㅓㄹㅏ	M EO G EO R A
ㄴㅕㄴ	N iEO N
ㅁㅕㅇㅇㅣㅇㅔㅇㅛ	M iEO NG I E iO
ㄴㅗㄱㅅㅐㄱ	N O k SS E k
ㅁㅜㄴㅇㅡㄹ	M U N EU L
ㄴㅡㅈㄱㅔ	N EU t GG E
ㅂㅏㄴㅊㅏㄴ	B A N CHh A N
ㅂㅓㅂㅇㅝㄴ	B EO B uEO N
ㅂㅗㅅㅕㅆㅇㅓㅇㅛ	B O S iEO SS EO iO
ㅂㅜㅁㅗㄴㅣㅁ	B U M O N I M
ㅂㅜㅇㅓㅋㅇㅔ	B U EO Kh E
ㄴㅜㄱㅜㅎㅏㄱㅗ	N U G U A G O
ㄲㅡㄱㅗ	G EU G O
ㄷㅏㄹㅡㄷㅏㄴㅡㄴ	D A R EU D A N EU N
ㄷㅏㅅㅓㅅ	D A S EO t
ㄷㅡㅇㄹㅗㄱㄱㅡㅁㅇㅔ	D EU NG N O k GG EU M E
ㄷㅏㄷㅇㅏ	D A D A
ㅁㅏㅇㅡㅁㅇㅔ	M A EU M E
ㅁㅕㅊㅣㄹ	M iEO CHh I L
ㅂㅣㄹㄹㅕㅈㅜㄹ	B I L L iEO J U L
ㅃㅏㄹㄱㅏㄴㅅㅐㄱ	BB A L G A N S E k
ㅅㅏㅇㅢ	S A euI
ㄲㅡㅌㅇㅣ	GG EU Th I
ㅅㅐㅇㅎㅘㄹㅇㅣ	S E NG H oA R I
ㄴㅏㄹㅆㅣㄱㅏ	N A L SS I G A
ㅅㅟㄹ	S UI L
ㅁㅗㅅㅎㅏㄴㄷㅏㅁㅕㄴ	M O Th A N D A M iEO N
ㅁㅏㄹㅎㅏㄱㅣㅇㅘ	M A R H A G I oA
ㅁㅜㄴㅇㅏㄴ	M U N A N
ㄴㅏㄱㅏㅆㅇㅓㅇㅛ	N A G A SS EO iO
ㅅㅐㄹㅗ	S E R O
ㄴㅐ	N E
ㄹㅏㅁㅕㄴㅇㅣ	R A M iEO N I
ㄷㅗㅊㅏㄱㅎㅐㅆㅇㅓㅇㅛ	D O CHh A Kh E SS EO iO
ㄴㅐㅇㅣㄹ	N E I R
ㅅㅣㄹㄹㅕㄱ	S I L L iEO k
ㅂㅏㄷㅏㅇㅢ	B A D A euI
ㅇㅏㅅㅔㅇㅛ	A S E iO
ㅂㅏㄲㅇㅡㄴ	B A GG EU N
ㄷㅏㄷㄴㅡㄴ	D A N N EU N
ㅂㅗㄹㅏㅅㅐㄱ	B O R A S E k
ㄷㅔ	D E
ㄴㅗㄱㄱㅣ	N O k GG I
ㄴㅜㄱㅏ	N U G A
ㄴㅡㄺㅇㅓㄱㅏㄴㅡㄴ	N EU L G EO G A N EU N
ㄴㅡㅈㅇㅓㅆㅇㅓ	N EU J EO SS EO
ㄷㅏㅅㅣ	D A S I
ㅇㅏㄶㅇㅡㄹ	A N EU L
ㅅㅜㄱㅗㅎㅏㄷㅏ	S U G O A D A
ㅂㅜㅇㅓㅋ	B U EO Kh
ㅅㅣㅇㅔ	S I E
ㅃㅏㅈㅕㅆㄴㅔㅇㅛ	BB A J iEO N N E iO
ㄷㅚㅂㄴㅣㄷㅏ	D OE M N I D A
ㅁㅓㄱㅇㅓㅇㅛ	M EO G EO iO
ㄷㅏㅇㅡㅁ	D A EU M
ㅁㅗㅅ	M O t
ㄷㅏㄻㅇㅏㅆㅇㅓㅇㅛ	D A L M A SS EO iO
ㄷㅏㄹㅋㅗㅁㅎㅏㄴ	D A L Kh O M H A N
ㅁㅏㄷㅇㅣ	M A D I
ㄷㅚㅇㅓ	D OE EO
ㅆㅓ	SS EO
ㄷㅡㄷㄱㅣㅇㅔㅅㅓㅂㅜㅌㅓ	D EU t GG I E S EO B U Th EO
ㅅㅐ	S E
ㄷㅡㄹㅇㅡㅁㅕㄴ	D EU R EU M iEO N
ㅅㅗㄹㅣ	S O R I
ㄹㅏㅁㅕㄴ	R A M iEO N
ㅁㅜㅇㅓㅅㅇㅣㄴㅈㅣ	M U EO S I N J I
ㅁㅏㄶㄱㅗ	M A N Kh O
ㄷㅙㅇㅛ	D OE iO
ㅁㅏㅅㅇㅣㅆㄷㅏ	M A S I t DD A
ㅇㅏㅊㅣㅁㅇㅢ	A CHh I M euI
ㅁㅓㄱㅇㅡㄹㄱㅓㄹ	M EO G EU L G EO R
ㅂㅐㄱㅗㅍㅏㅇㅛ	B E G O Ph A iO
ㄷㅗㄴㅇㅡㄴ	D O N EU N
ㅂㅘㅆㄴㅡㄴㄷㅔ	B oA N N EU N D E
ㄷㅜㅂㅜ	D U B U
ㅂㅜㄹㅇㅡㄹ	B U R EU L
ㄷㅡㄷㄱㅣㅇㅘ	D EU t GG I oA
ㅁㅐㄱㄹㅏㄱ	M E NG N A k
ㅇㅓㄹㄱㅜㄹ	EO L G U L
ㅁㅗㅅㅎㅏㅈㅣㅁㅏㄴ	M O Th A J I M A N
ㅁㅕㅊ	M iEO t
ㅁㅜㄹㅇㅣ	M U R I
ㅅㅣㄴㅐㅅㅁㅜㄹ	S I N E N M U L
ㄷㅡㄹㅁㅕㄴ	D EU L M iEO N
ㅅㅣㅍㅅㅡㅂㄴㅣㄷㅏ	S I p SS EU M N I D A
ㅅㅏㄹㅏㅇㅎㅏㄴㄷㅏ	S A R A NG H A N D A
ㄸㅏㄹㅏㅅㅓ	D A R A S EO
ㅇㅕㅁㅈㅡㅇ	iEO M J EU NG
ㅁㅏㄱ	M A k
ㅇㅗㅈㅓㄴ	O J EO N
ㅁㅏㄹㅆㅡㅁㅎㅐ	M A L SS EU M H E
ㅇㅝㄴㅁㅏㄴ	uEO N M A N
ㅁㅓㄹㅣㅋㅏㄹㅏㄱㅇㅡㄹ	M EO R I Kh A R A G EU R
ㅇㅢㅅㅏㅅㅗㅌㅗㅇ	euI S A S O Th O NG
ㅁㅗㄷㅜ	M O D U
ㅅㅐㅇㄱㅣㄴ	S E NG G I N
ㅁㅜㄹㅡㅍ	M U R EU p
ㅇㅓㄷㅣㅇㅔㅅㅓ	EO D I E S EO
ㅁㅣㅇㅏㄴ	M I A N
ㅁㅜㄴㅢ	M U N euI
ㄸㅟㅇㅓㅅㅓ	DD UI EO S EO
ㅁㅜㄹㅎㅏㄱㅗ	M U R H A G O
ㅁㅏㄱㅎㅕ	M A Kh iEO
ㅂㅏㄹㅏㅁ	B A R A M
ㅇㅣㅇㅢ	I euI
ㅂㅏㄹㄷㅡㅇ	B A L D EU NG
ㅁㅣㄹㅣ	M I R I
ㅁㅝㄹㅏㄱㅗ	M uEO R A G O
ㅇㅕㄱㅣ	iEO G I
ㄷㅡㄷㄱㅣㄱㅏ	D EU t GG I G A
ㅇㅗ	O
ㄷㅡㄹㅇㅓㅇㅛ	D EU R EO iO
ㅅㅜㅇㅓㅂㅇㅡㄴ	S U EO B EU N
ㅂㅕㄱㅇㅔ	B iEO G E
ㅅㅣㄱㄷㅏㅇㅇㅔ	S I k DD A NG E
ㅂㅗㄹㄱㅔㅇㅛ	B O L G E iO
ㅇㅏㄴㅣㅇㅑ	A N I iA
ㅂㅜㅂㅜ	B U B U
ㅇㅏㄶㅇㅡㅅㅕㅆㅇㅓㅇㅛ	A N EU S iEO SS EO iO
ㅇㅏㅊㅣㅁㅇㅡㄹ	A CHh I M EU L
ㅇㅚㄱㅜㄱ	OE G U k
ㅇㅓㄷㅣㄹㅗ	EO D I R O
ㅇㅡㄴㅎㅐㅇㅇㅣ	EU N E NG I
ㅇㅕㄱㅝㄴ	iEO G uEO N
ㅂㅏㅋㅟ	B A Kh UI
ㅂㅏㄹㅏㅁㅈㅣㄱㅎㅏㅈㅣ	B A R A M J I Kh A J I
ㅂㅜㄹㅂㅜㅌㅓ	B U L B U Th EO
ㅁㅏㄹㅇㅡㄹ	M A R EU L
ㅃㅏㄹㄹㅐ	BB A L L E
ㅇㅓㅁㅓㄴㅣ	EO M EO N I
ㅇㅣㄹㅇㅣㄹㅏㅁㅕㄴ	I R I R A M iEO N
ㅂㅏㄹ	B A L
ㅈㅏㄹㅣ	J A R I
ㅇㅣㄸㅏ	I DD A
ㅇㅖㅅㄴㅏㄹ	iE N N A L
ㅇㅣㄹㅂㅗㄴ	I L B O N
ㅁㅓㄱㄷㅓㄴ	M EO k DD EO N
ㄸㅟㄴㄷㅏ	DD UI N D A
ㅇㅕㄹㅓㅂㅜㄴㄱㅘ	iEO R EO B U N G oA
ㅅㅏㄹㅓ	S A R EO
ㅇㅗㄹㅐㄷㅚㄴ	O R E D OE N
ㅅㅐㄱㄲㅏㄹㅇㅡㄹ	S E k GG A R EU L
ㅇㅜㄹㅣㄴㅏㄹㅏ	U R I N A R A
ㅈㅓㄴㅎㅘㅎㅏㄹㄱㅔ	J EO N oA A L G E
ㅇㅘㅆㅇㅓㅇㅛ	oA SS EO iO
ㅇㅣㅆㅇㅓㅆㅇㅓㅇㅛ	I SS EO SS EO iO
ㅇㅠㅊㅣㅇㅝㄴ	iU CHh I uEO N
ㅁㅏㄴㄷㅡㄴㅡㄴ	M A N D EU N EU N
ㅇㅣㄱㅔ	I G E
ㅁㅏㄹㅎㅐ	M A R H E
ㅇㅣㄹㄱㅗㅂ	I L G O p
ㅁㅓㄱㅇㅓㅆㅇㅓㅇㅛ	M EO G EO SS EO iO
ㅂㅏㅂ	B A p
ㅁㅗㅅㅎㅏㄱㅔㅆㅅㅡㅂㄴㅣㄷㅏ	M O Th A G E S SS EU M N I D A
ㅁㅗㄹㄹㅏㅆㄴㅡㄴㄷㅔ	M O L L A N N EU N D E
ㅂㅕㄹㅇㅣㄹ	B iEO R I N
ㅁㅜㅅㅡㄴ	M U S EU N
ㅂㅐㄱㅈㅓㅁ	B E k JJ EO M
ㅁㅝㄴㅈㅣ	M uEO N J I
ㅂㅗㅈㅏㄱㅣ	B O J A G I
ㅂㅏㅃㅡㄷㅏ	B A BB EU D A
ㅇㅣㅆㅅㅡㅂㄴㅣㄷㅏ	I S SS EU M N I D A
ㅂㅏㅇㅅㅗㅇ	B A NG S O NG
ㅈㅓㅎㅢ	J EO euI
ㅈㅓㄹㅓㅎㄱㅔ	J EO R EO Kh E
ㅂㅗㅁ	B O M
ㅅㅓㄷㅜㄹㄹㅓㅆㅇㅡㄹ	S EO D U L L EO SS EU L
ㅇㅢㅅㅏ	euI S A
ㅁㅜㄴㅎㅘㅇㅔ	M U N oA E
ㅇㅣㄹㅡㅁㅇㅣ	I R EU M I
ㅂㅏㄲㅜㄷㅏ	B A GG U D A
ㅇㅣㄹㅇㅛㅇㅣㄹㅇㅣ	I R iO I R I
ㅂㅏㄷㅇㅏㅆㄷㅏ	B A D A t D A
ㅇㅣㅆㅇㅡㅁㅕㄴ	I SS EU M iEO N
ㅂㅐㄱㅎㅘㅈㅓㅁㅇㅡㄹ	B E Kh oA J EO M EU L
ㅈㅓㄴㅎㅏㄹ	J EO N A L
ㅂㅗㅌㅗㅇ	B O Th O NG
ㅂㅜㄴㅡㄴ	B U N EU N
ㅂㅜㄹㅓㅂㅈㅣ	B U R EO p JJ I
ㅂㅜㄹㅁㅏㄴㅇㅣ	B U L M A N I
ㅂㅜㄴㅇㅣ	B U N I
ㅂㅣㅊㅇㅡㄹ	B I CHh EU L
ㅈㅗㅅㅏ	J O S A
ㅂㅜㄴ	B U N
ㅈㅗㅎㅈㅣ	J O CHh I
ㅈㅗㅎㄱㅔㅆㅇㅓㅇㅛ	J O Kh E SS EO iO
ㅈㅗㅎㅅㅡㅂㄴㅣㄷㅏ	J O SS EU M N I D A
ㅂㅕㅇㅇㅝㄴ	B iEO NG uEO N
ㅈㅜㅅㅔㅇㅛ	J U S E iO
ㅂㅘ	B oA
ㅈㅡㄹㄱㅣㄴㄷㅏ	J EU L G I N D A
ㅈㅗㅁ	J O M
ㅅㅜㄹㅣ	S U R I
ㅈㅗㅎㅇㅡㄹㄲㅏㅇㅛ	J O EU L GG A iO
ㅂㅜㅌㅇㅓ	B U Th EO
ㅈㅚㅅㅗㅇㅎㅐㅅㅓ	J OE S O NG H E S EO
ㅃㅏㄹㄹㅣ	BB A L L I
ㅃㅏㄹㅡㄹㅅㅜㄹㅗㄱ	B A R EU L S U R O k
ㅂㅜㄴㅇㅔ	B U N E
ㅅㅏㄱㅘ	S A G oA
ㅂㅜㅌㅇㅣㅅㅔㅇㅛ	B U Th I S E iO
ㅅㅏㅁㅅㅣㅂ	S A M S I p
ㅃㅏㅇ	BB A NG
ㅈㅜㅇㄱㅜㄱ	J U NG G U k
ㅂㅏㅇㅇㅔㅅㅓ	B A NG E S EO
ㅈㅣㄴㅉㅏ	J I N JJ A
ㅂㅗㄴㅣ	B O N I
ㅈㅜㅇㅇㅛㅎㅏㄹㄲㅏ	J U NG iO A L GG A
ㅈㅣㅅㅇㅣㄷㅏ	J I S I D A
ㅅㅟㅂㅈㅣ	S UI p JJ I
ㅈㅜㅇㅇㅔㅅㅓ	J U NG E S EO
ㅅㅐㅇㄱㅏㄱㅎㅏㄱㅗ	S E NG G A Kh A G O
ㅅㅏㅈㅣㄴㅇㅡㄹ	S A J I N EU L
ㅅㅜ	S U
ㅊㅐㅅㅗ	CHh E S O
ㅅㅏㄹㅏㅁㅇㅣ	S A R A M I
ㅂㅘㅇㅛ	B oA iO
ㅈㅣㅂㅈㅣㅂㅁㅏㄷㅏ	J I p JJ I M M A D A
ㅊㅣㅁㄷㅐ	CHh I M D E
ㅊㅐㄱㅇㅣㅁㅇㅣㅇㅑ	CHh E G I M I iA
ㅅㅣㅈㅏㅇㅇㅔ	S I J A NG E
ㅅㅏㅇㅛㅇㅎㅏㄴㅡㄴ	S A iO NG H A N EU N
ㅅㅐㅇㄱㅏㄱ	S E NG G A k
ㅅㅐㄱㅇㅡㄹ	S E G EU L
ㅅㅔㅅㅜ	S E S U
ㅅㅓㄴㅅㅐㅇㄴㅣㅁㅇㅣ	S EO N S E NG N I M I
ㅅㅜㅇㅓㅂㅇㅔ	S U EO B E
ㅂㅜㄴㅇㅟㄱㅣㄱㅏ	B U N UI G I G A
ㅈㅣㄴㅈㅓㅇㅎㅏㄴ	J I N J EO NG H A N
ㅍㅗㅎㅏㅁㄷㅙㅇㅛ	Ph O A M D OE iO
ㅊㅐㄱㅅㅏㅇ	CHh E k SS A NG
ㅎㅏㄴㄱㅜㄱㅁㅏㄹㅇㅡㄹ	H A N G U NG M A R EU L
ㅍㅏㄹㅍㅏㄹ	Ph A L Ph A L
ㅅㅏㅇㄱㅡㅁ	S A NG G EU M
ㅅㅜㅇㅓㅂ	S U EO M
ㅅㅐㅇㄱㅏㄱㅎㅏㄴㄷㅏ	S E NG G A Kh A N D A
ㅅㅣㄲㅏㅈㅣ	S I GG A J I
ㅅㅗㄹㅣㄹㅡㄹ	S O R I R EU L
ㅅㅣㄹㄴㅐ	S I N N E
ㅅㅣㅇㅅㅣㅇㅎㅏㄷㅏ	S I NG S I NG H A D A
ㅆㅗㄱ	SS O G
ㅎㅗㄴㅈㅏ	H O N J A
ㅎㅏㄱㄱㅛㅇㅔ	H A k GG iO E
ㅍㅕㄴㅎㅏㄴ	Ph iEO N A N
ㅅㅣ	S I
ㅎㅏㄴ	H A N
ㅅㅣㅎㅓㅁ	S I EO M
ㅎㅓㄹㅣ	H EO R I
ㅅㅟㄷㅏ	S UI D A
ㅎㅣㅁㄷㅡㄹㅇㅓㅆㅇㅓㅇㅛ	H I M D EU R EO SS EO iO
ㅇㅏㄹㅡㅁㄷㅏㅇㅜㄴ	A R EU M D A U N
ㅎㅐㄷㅗ	H E D O
ㅅㅜㅇㅓㅂㅇㅣ	S U EO B I
ㅎㅢㅁㅏㅇ	H euI M A NG
ㅅㅣㅈㅏㄱㅎㅐㅇㅛ	S I J A Kh E iO
ㅅㅣㅍㄷㅏ	S I p DD A
ㅇㅏㅈㅜ	A J U
ㅇㅏㅂㅓㅈㅣㅇㅘ	A B EO J I oA
ㅇㅏㄵㄱㅗ	A N G O
ㅇㅏㅎㅗㅂ	A O p
ㅅㅣㅂㅁㅏㄴ	S I M M A N
ㅇㅏㄹㅇㅏㅆㄷㅏㅁㅕㄴ	A R A t DD A M iEO N
ㅅㅣㅈㅏㄱㅎㅏㄴㄷㅏㄱㅗ	S I J A Kh A N D A G O
ㅇㅏㄴ	A N
ㅅㅣㄹㅅㅜㅎㅏㅈㅣ	S I L S U A J I
ㅂㅣㅂㅣㅁㅂㅏㅂ	B I B I M B A p
ㅇㅏㄶㅇㅡㄹㄲㅏ	A N EU L GG A
ㅍㅏㅇㅏㄱㅎㅏㅈㅣ	Ph A A Kh A J I
ㅇㅓㄸㅓㅎㄱㅔ	EO DD EO Kh E
ㅎㅏㄱㅈㅏㅇㅢ	H A k JJ A euI
ㅆㅗㄷㅇㅏㅇㅛ	SS O D A iO
ㅆㅡㄱㅣ	SS EU G I
ㅇㅏㅈㅣㄱ	A J I k
ㅇㅏㅈㅣㄱㄷㅗ	A J I k DD O
ㅃㅜㄹㅣ	BB U R I
ㅇㅏㄶㄱㅔㅆㅈㅣㅁㅏㄴ	A N Kh E t JJ I M A N
ㅇㅓㅄㅇㅓㅆㅇㅓㅇㅛ	EO p SS EO SS EO iO
ㅇㅓㄸㅐㅇㅛ	EO DD E iO
ㅇㅕㄹㄹㅕㅆㄴㅔㅇㅛ	iEO L L iEO N N E iO
ㅇㅓㄹㄱㅜㄹㅇㅣ	EO L G U R I
ㅇㅖㅈㅓㅇㅇㅣㅅㅣㅂㄴㅣㄲㅏ	iE J EO NG I S I M N I GG A
ㅇㅕㄱㅣㄲㅏㅈㅣ	iEO G I GG A J I
ㅅㅏㄹㅇㅣ	S A R I
ㅇㅗㅅㅣㅂ	O S I M
ㅅㅐㄱㅈㅗㅇㅇㅣ	S E k JJ O NG I
ㅎㅐㄷㅗㄷㅇㅣ	H E D O D I
ㅇㅓㄷㅣ	EO D I
ㅎㅣㅁㄷㅡㄴ	H I M D EU N
ㅇㅑㄱㅜ	iA G U
ㅇㅏㄵㅇㅏㅅㅓ	A N J A S EO
ㅇㅓㄸㅓㄴ	EO DD EO N
ㅅㅓㅇㅈㅏㅇㅎㅐㅆㅅㅡㅂㄴㅣㄷㅏ	S EO NG J A NG H E S SS EU M N I D A
ㅇㅑㄱㄱㅜㄱ	iA k GG U k
ㅇㅕㅇㅇㅓ	iEO NG EO
ㅇㅓㄴㄴㅣ	EO N N I
ㅇㅛㅇㄷㅗㄴㅇㅡㄴ	iO NG D O N EU N
ㅅㅜㅇㅓㅂㄹㅛㄱㅏ	S U EO M N iO G A
ㅇㅟ	UI
ㅅㅣㄱㅖ	S I G iE
ㅇㅓㅄㄷㅏ	EO p DD A
ㅇㅡㅁㅅㅣㄱㄱㅘ	EU M S I k GG oA
ㅇㅓㅄㅇㅡㅁㅕㄴ	EO p SS EU M iEO N
ㅇㅗㅁㅕㄴ	O M iEO N
ㅅㅣㄴㄱㅗ	S I N G O
ㅇㅕㄷㅓㄼ	iEO D EO L B
ㅆㅏㄷㅏ	SS A D A
ㅇㅕㅇㅇㅕㄱㅇㅣ	iEO NG iEO G I
ㅇㅏㅇㅣㅅㅡㅋㅡㄹㅣㅁ	A I S EU Kh EU R I M
ㅇㅕㄹㅅㅣㅁㅎㅣ	iEO L S I M H I
ㅇㅏㄴㄴㅕㅇㅎㅏㅅㅔㅇㅛ	A N N iEO NG H A S E iO
ㅇㅓㄴㅈㅔㄷㅡㄴㅈㅣ	EO N J E D EU N J I
ㅇㅏㅀㄷㅓㄴㅣ	A L Th EO N I
ㅇㅘㅇㅑ	oA iA
ㅇㅗㄴㅡㄹ	O N EU L
ㅇㅜㄴㄷㅗㅇㅎㅘㄹㅡㄹ	U N D O NG H oA R EU L
ㅇㅣ	I
ㅇㅡㄴㅎㅐㅇ	EU N E NG
ㅇㅓㅄㅇㅡㄹㄲㅏㅇㅛ	EO p SS EU L GG A iO
ㅇㅣㅂㅓㄴㅇㅔㄴ	I B EO N E N
ㅇㅕㄹㅇㅓㅆㅇㅓㅇㅛ	iEO R EO SS EO iO
ㅇㅣㄴㄹㅠ	I N N iU
ㅇㅢㅅㅏㅅㅗㅌㅗㅇㅇㅡㄴ	euI S A S O Th O NG EU N
ㅇㅗㅅㅔㅇㅛ	O S E iO
ㅇㅗㅅㅇㅣㄹㅏㄱㅗ	O S I R A G O
ㅇㅓㄸㅓㄱㅎㅏㅈㅛ	EO DD EO Kh A CHh iO
ㅇㅜㄹㅣ	U R I
ㅇㅗㄴㅡㄹㅇㅡㄴ	O N EU R EU N
ㅇㅟㅇㅔ	UI E
ㅇㅘㅅㅓ	oA S EO
ㅇㅓㅂㅁㅜㅇㅔ	EO M M OE
ㅇㅣㄹㅉㅣㄱ	I L JJ I k
ㅇㅣㄹㅓㄴ	I R EO N
ㅇㅣㅆㄱㅣ	I t GG I
ㅇㅣㅎㅐ	I E
ㅇㅜㄹㅣㄱㅏ	U R I G A
ㅇㅣㄹㅇㅓㄴㅏㅅㅓ	I R EO N A S EO
ㅇㅟㅎㅐ	UI E
ㅇㅘㅆㅅㅡㅂㄴㅣㄷㅏ	oA S SS EU M N I D A
ㅇㅢㄱㅕㄴㅇㅣ	euI G iEO N I
ㅈㅏㅈㅜㅅㅐㄱ	J A J U S E k
ㅇㅣㅂㄱㅗ	I p GG O
ㅈㅓㄴ	J EO N
ㅇㅣㅆㅇㅡㅅㅣㅁㅕㄴ	I S EU S I M iEO N
ㅇㅞㄴ	OE N
ㅇㅣㄱㅓㅅ	I G EO t
ㅇㅡㅁㄹㅛㅅㅜㅎㅏㄱㅗ	EU M N iO S U A G O
ㅇㅣㅇㅑㄱㅣ	I iA G I
ㅇㅢㅅㅏㅅㅗㅌㅗㅇㅇㅡㄹ	euI S A S O Th O NG EU L
ㅇㅣㄹ	I L
ㅇㅣㄹㅓㅎㄱㅔ	I R EO Kh E
ㅇㅣㄺㄱㅣ	I k GG I
ㅇㅣㅎㅐㅎㅏㄱㅣ	I E A G I
ㅈㅓㅇㄷㅗㄹㅗ	J EO NG D O R O
ㅇㅣㄹㅇㅡㄴ	I R EU N
ㅇㅕㄹㅓㅂㅜㄴ	iEO R EO B U N
ㅇㅣㅆㄷㅗㄹㅗㄱ	I t DD O R O k
ㅈㅐㅁㅣㅇㅣㅆㅇㅡㄹ	J E M I I SS EU L
ㅈㅏㄱㄴㅕㄴ	J A NG N iEO N
ㅇㅢㄱㅕㄴㄹㅏㄴㅇㅔ	euI G iEO N N A N E
ㅈㅓㄴㅇㅔ	J EO N E
ㅈㅗㅎㄷㅏ	J O Th A
ㅇㅣㅂㄱㅜ	I p GG U
ㅈㅗㅎㅇㅡㄴ	J O EU N
ㅇㅣㅆㅇㅡㄹ	I SS EU L
ㅇㅖㅈㅓㄴ	iE J EO N
ㅈㅓㅅㄱㅏㄹㅏㄱ	J EO t GG A R A k
ㅈㅓㄹㄷㅐㄹㅗ	J EO L D E R O
ㅈㅗㅇㄹㅗ	J O NG N O
ㅈㅔㄱㅏ	J E G A
ㅈㅗㅎㅇㅏㅎㅏㅅㅔㅇㅛ	J O A A S E iO
ㅇㅗㅅㅕㅆㅇㅓㅇㅛ	O S iEO SS EO iO
ㅇㅣㄱㅓ	I G EO
ㅈㅓㄴㅡㄴ	J EO N EU N
ㅈㅜㅅㅣㄱㅣ	J U S I G I
ㅈㅗㅎㅇㅏㅇㅛ	J O A iO
ㅈㅜㄹㄴㅓㅁㄱㅣ	J U N N EO M G I
ㅈㅘㅅㅓㄱ	J oA S EO k
ㅇㅙ	OE
ㅈㅜㅅㅣㅈㅣ	J U S I J I
ㅈㅓㄻㄱㅗ	J EO L M G O
ㅈㅜㅇㅇㅛㅎㅏㄱㅗ	J U NG iO A G O
ㅇㅣㅇㅓㄴㅏㄱㅏㄴㅡㄴ	I EO N A G A N EU N
ㅈㅣㅎㅏㅊㅓㄹㅇㅕㄱㅇㅔ	J I A CHh EO R iEO G E
ㅇㅞㄴㅇㅣㄹㄹㅗ	OE N I L L O
ㅈㅣㅅㄴㅜㄹㅡㄷㅏ	J I N N U R EU D A
ㅇㅡㅁㅅㅣㄱ	EU M S I k
ㅊㅏㅁ	CHh A M
ㅇㅢㅈㅏ	euI J A
ㅌㅏㄱㅗ	Th A G O
ㅈㅗㄱㅡㅁㅇㅣㅈㅣ	J O G EU M I J I
ㅈㅣㅎㅏㅊㅓㄹ	J I A CHh EO L
ㅇㅣㄴㅈㅓㅇㄷㅚㄴ	I N J EO NG D OE N
ㅈㅣㅂㅇㅔ	J I B E
ㅇㅣㅂ	I p
ㅌㅡㄱㅎㅣ	Th EU Kh I
ㅇㅣㅆㅇㅓㅇㅛ	I SS EO iO
ㅇㅣㄹㅡㄴ	I R EU N
ㅈㅏㄹ	J A L
ㅇㅣㅎㅐㅎㅐㅇㅑ	I E E iA
ㅈㅓㄴㅌㅗㅇㅇㅡㄹ	J EO N Th O NG EU L
ㅇㅣㄹㅇㅡㄹ	I R EU L
ㅍㅡㄹㅏㅇㅅㅡㅇㅔㅅㅓ	Ph EU R A NG S EU E S EO
ㅇㅣㅆㄱㅜㄴㅏ	I t GG U N A
ㅉㅣㄱㅇㅡㅁㅕㄴ	JJ I G EU M iEO N
ㅈㅓㅇㅁㅏㄹ	J EO NG M A L
ㅊㅣㄴㄱㅜ	CHh I N G U
ㅈㅗㅎㄷㅓㄴㄷㅔㅇㅛ	J O Th EO N D E iO
ㅎㅏㅅㅣㄹ	H A S I N
ㅈㅗㅎㅇㅡㄴㄷㅔ	J O EU N D E
ㅈㅏㅇㅕㄴㅅㅡㄹㅓㅂㄱㅔ	J A iEO N S EU R EO p GG E
ㅈㅜㅅㅣㅁㅕㄴ	J U S I M iEO N
ㅈㅓㄱㅎㅏㅂㅎㅏㄴ	J EO Kh A Ph A N
ㅈㅜㄹㄹㅣㅇㅏㅇㅇㅣㄹㅏㄱㅗ	J U L L I A NG I R A G O
ㅈㅓㅂㅅㅜ	J EO p SS U
ㅈㅜㅁㅏㄹㅇㅔ	J U M A R E
ㅌㅚㄱㅡㄴ	Th OE G EU N
ㅎㅏㅂㄴㅣㄷㅏ	H A M N I D A
ㅍㅗㄱㅂㅏㄹ	Ph O k BB A L
ㅎㅐㅆㄱㅜㄴㅏ	H E t GG U N A
ㅎㅏㄴㅡㄹㅇㅡㄹ	H A N EU R EU L
ㅈㅜㅈㅏㅇㅎㅏㄱㅗ	J U J A NG H A G O
ㅎㅏㄴㄱㅜㄱㅇㅓ	H A N G U G EO
ㅈㅣㄱㅏㅂㅇㅣ	J I G A B I
ㅈㅗㅎㅇㅏㅎㅏㅁㅕ	J O A A M iEO
ㅈㅣㄱㅈㅓㅂ	J I k JJ EO p
ㅈㅣㅎㅏㅊㅓㄹㅇㅕㄱㄲㅏㅈㅣ	J I A CHh EO R iEO k GG A J I
ㅎㅐㄱㅕㄹㅇㅡㄹ	H E G iEO R EU L
ㅈㅗㅎㄱㅔㅆㄴㅔㅇㅛ	J O Kh E N N E iO
ㅎㅜㅊㅜ	H U CHh U
ㅈㅗㅎㅇㅏㅎㅏㄴㄷㅏ	J O A A N D A
ㅈㅚㅅㅗㅇㅎㅏㅈㅣㅁㅏㄴ	J OE S O NG H A J I M A N
ㅈㅣㅂㅇㅔㅅㅓ	J I B E S EO
ㅎㅡㄴㄷㅡㄹㄷㅏ	H EU N D EU L D A
ㅉㅣㄷㅏ	J I D A
ㅈㅜㅅㅣㄱㅔㅆㅇㅓㅇㅛ	J U S I G E SS EO iO
ㅈㅜㅅㅣㄴ	J U S I N
ㅊㅏㅇㅣㅈㅓㅁㅇㅣ	CHh A I J EO M I
ㅊㅏㅈㅇㅏㅈㅜㅅㅕㅅㅓ	CHh A J A J U S iEO S EO
ㅈㅜㄹ	J U L
ㅈㅡㄹㄱㅓㅂㄴㅔㅇㅛ	J EU L G EO p N E iO
ㅋㅣ	Kh I
ㅌㅔㄴㄷㅔㅇㅛ	Th E N D E iO
ㅈㅣㄱㅡㅁ	J I G EU M
ㅈㅣㄱㅈㅏㅇㅇㅣ	J I k JJ A NG I
ㅌㅚㄱㅡㄴㅎㅏㅈㅣ	Th OE G EU N A J I
ㅍㅕㄴㅈㅣ	Ph iEO N J I
ㅈㅣㄹㅁㅜㄴ	J I L M U N
ㅉㅏㅇㅛ	JJ A iO
ㅍㅜㄹ	Ph U L
ㅎㅏㄴㅡㄴ	A N EU N
ㅉㅣㄱㅇㅓㅇㅑ	JJ I G EO iA
ㅊㅏㅇㅁㅜㄴㅇㅣ	CHh A NG M U N I
ㅎㅏㄹㅜㅁㅏㄴ	H A R U M A N
ㅎㅏㄴㄱㅜㄱ	A N G U G
ㅋㅕㄹㄹㅔ	Kh iEO L L E
ㅌㅏㅇㅛ	Th A iO
ㅎㅏㄴㄱㅜㄱㅇㅓㄹㅡㄹ	H A N G U G EO R EU L
ㅎㅏㅇㅅㅏㅇ	H A NG S A NG
ㅌㅚㄱㅡㄴㅅㅣㄱㅏㄴㅇㅣㄹㅏㅅㅓ	Th OE G EU N S I G A N I R A S EO
ㅍㅏㄷㅗ	Ph A D O
ㅎㅐㄱㅅㅣㅁㅇㅣ	H E k SS I M I
ㅎㅘㄱㅏ	H oA G A
ㅍㅛㅎㅕㄴ	Ph iO iEO N
ㅎㅏㄱㅔㅆㅇㅓㅇㅛ	A G E SS EO iO
ㅎㅡㄹㅡㄴㅡㄴ	H EU R EU N EU N
ㅎㅢㄲㅡㅅㅎㅢㄲㅡㅅㅎㅏㄴ	H euI GG EU Th euI GG EU Th A N
ㅎㅏㅅㅕㅆㅇㅓㅇㅛ	H A S iEO SS EO iO
ㅎㅏㄱㄱㅛㄲㅏㅈㅣ	H A k GG iO GG A J I
ㅎㅏㄴㅂㅓㄴ	H A N B EO N
ㅎㅏㅂㅂㅓㅂㅈㅓㄱㅇㅡㄹㅗ	H A p BB EO p JJ EO G EU R O
ㅎㅐ	E
ㅎㅐㅆㄴㅡㄴㅈㅣ	H E N N EU N J I
ㅎㅚㅇㅢ	H OE euI
ㅎㅡㄺㅁㅏㄹㅜ	H EU NG M A R U
ㅎㅣㅁㄷㅡㄹ	H I M D EU L
